##################################################
#                                       # #=#    #
#                                       # #=#    #
#                                       # #=     #
#                                       # #=#    #
#                                       # #=#    #
#                                       # #=#    #
#                                         ==#    #
#                                       # #=#    #
##################################################