########################################
#                              #=#     #
#                              #=#     #
#                              #=#     #
#                              #=#     #
#                              #==     #
#                              #=#     #
#                              #=#     #
#                              #=#     #
#                              #=#     #
#                              #=#     #
#                              #=#     #
#                              ==#     #
#                              #=#     #
#                              #=#     #
#                              #=#     #
#                              #=#     #
#                              #=#     #
########################################